bla
height 10
width 10
bla
@@@@@@@@@.
........@.
.@@@@@@.@.
.@....@.@.
.@.@@.@.@.
.@.@..@.@.
.@.@@@@.@.
.@......@.
.@@@@@@@@.
..........