type heuristic
height 64
width 64
unnecessary line of text
.......@....@..@.@@...........@@.......@@@...................@..
@..@.@......@........@@.................@......@.........@......
........@.....................................@@................
....@.@...@.......@...........@.@...............@.@..@..........
....@.............................................@...@.........
....@@..................@.................@...@.........@.......
.....................................................@..........
...@..........................@.....@...........................
...@.@........@@...........@.@...@..@.........@............@....
..........@.........@@.....@....................@............@..
........@....@.@......@.........@@.@.........@@@..........@.....
...@...........@@...........@..........@.......@................
...@.@..@@......@.@....................@....................@...
............@....@@......................@..@.....@...........@@
........@......@.@.............@@...............@@..............
........@....@.@@..@.............@.@.........@...@@.....@.@.....
...@....@..@........@............@@...........@........@...@.@@.
.....................@....................................@.....
.@.................................@@.@........................@
.......@.....................@.................@................
@..@...@..................@@....................@...............
...@.......@..................@.............@...............@...
..@@...............................................@............
.................@................................@.............
.@@.......@...........@@..........@............@...@......@.....
.......@......@...............@........................@........
@...................................@...........................
@..@.....@...@......@......@.............................@......
.....@....@@.......@................@...........................
..@................@.....@......................................
...@@...@....................@.@...........@.@......@.@....@..@.
..@..............@@..@@...@........@..@.@....@..@@..........@..@
....@.............@...........@@..............................@.
...................@.................................@..........
.........@.......@.@...........................................@
.@.....@...........@@...........@....@..@..@@.@.@...@@.......@..
...........@..@@@...@..............@...............@........@...
.....@......@...@.........................@.....................
@....................@........................@.................
...@@..........@..............................@..@...@.@......@.
...@..@................................@.......@...@.....@......
....................@...............................@..@........
.@................@.........@..........@.......@.......@...@....
...@@.............@..@......@...@@.......@..............@..@....
.@.@.........@.......@@.............@........@..................
..........@....@......@......@...@...@...@............@.........
.........@......@.................@....@....@...................
........@.............................@....@................@..@
...@...............................@........@.....@.............
........................@@.......@..@....................@...@@.
....................@....@..@@..................................
.........@..............@........@.@.......@..@.......@.........
...........@......@...@..@...........@..........................
...@...@.......@..@......@...........................@..........
.....@...@...............................@.@.@...........@....@.
.......@.@..@@...........@....@........@...........@...@........
............@...................................@.........@@..@.
......................@..@........@....@....@............@......
............@.@@....@...@................@......................
............@............@...............@.....@................
.....@..@.@....@...........@...@...@................@.......@...
..@..................@..@@.......@..@........@...@.......@..@..@
......................@.................@............@@..@......
........@.@.@......@......@.........@............@@.....@@......
