type heuristic
height 20
width 20
unnecessary line of text
...@@..@.@.....@.@..
....@...@.......@..@
..@.........@@......
.@.@@.@..@..@@......
@..@@...............
@.....@.@......@...@
..@..@....@.........
.@@@...@.........@..
@@..@@..@@.@@.@.....
.@..@....@.@.......@
@..@@..@.@.@@@..@..@
.@@.......@....@.@.@
.@@@.@.@...@@@.@.@@@
.@@.@.@...@@@.@.....
@........@...@..@@..
@..@...@...@.@@...@.
@.......@.@..@.@...@
@..@@...@.@.@..@.@..
....@......@.@.....@
......@@......@@....
