type heuristic
height 32
width 32
unnecessary line of text
.@@@....@....@.@.@@....@........
...@....@.........@.....@.......
....@...@.@@.....@..............
........@....@..@..@....@...@...
.......@@.@..@......@.@..@.@....
@.@.....@....@.@..........@.@...
....@......@..............@@...@
..@...@......@..@.......@@....@.
@.............@@..@@@.@.@......@
..............@....@..........@.
...........@@.....@.....@.......
@..@..@.......@@..@............@
.@..@.@.@.@.......@@......@....@
@.......@......@...@@.@..@@...@.
@........@.....@@.@......@......
.@..@.@@.@@.....@......@.....@..
....@@.@......@.@............@..
.....@..@@.@....@@@.@......@...@
@..@@@.@......@....@@...........
.........................@......
..@......@.....@..............@.
.@.........................@....
...@......@.@..@@...............
.@...........@.....@.....@...@.@
.@.........@.@..@@....@@..@.@...
..@.@.....@..@..........@...@...
..........@@@...@...............
.@.....@@....@......@....@....@.
.@@..@..@......@..@@....@@@....@
@.@..@.@..@......@......@.......
....@....@...@..@.....@....@@...
......@..........@..@.@.........
