type heuristic
height 10
width 10
unnecessary line of text
..@....@..
..........
..........
..........
@..@@....@
..........
..........
..@@......
....@....@
..........
