type heuristic
height 128
width 128
unnecessary line of text
....@.@.....@..@@@.@..@.....@@...@...@@@...@...@..@...@@....@.@.....@.@@.@..@.....@.@.@...@...@@..@..@@...@....@.@@@@@..@@@.@...
..@@.@@@@@@..@@.@@.@.@.....@...@..@.....@@.@.@....@@..@.@......@@..........@.........@......@......@@@...@.@.@.@@.@@...@@...@...
@..........@...........@...@.@...@......@.@@..@.......@..@@..@@@..@..@.......@..@@......@@.@.@@....@..@.....@@....@....@@..@.@.@
....@....@@@.....@....@@...@........@.....@.@...@.....@.....@..@...@...@.@.........@@.....@.@@@....@........@..@.@...........@@@
@@@......@.@...@@.@@.....@...@.@.@...@@.@..@.@...@......@..@...@..@.@..@@.......@.@.@..@.@..@@.....@......@..@@@.@@.....@.@@....
@..@...@.@..@...@..@.@.@.@@.@.@@.@.@...@...........@@.@...@.@...@......@..@...@.@.@@@.@@@@@@.....@@@..@.........@@...@......@..@
.......@........@@....@...@....@.....@@.@.@..@.@......@.@@@...@@@.......@@.....@@..@.@.@@...@.....@.@.@..@@....@..@@...@...@@..@
@.@..@@...@@@@..@..@..@..@.@@@...@.@....@......@........@@.......@.....@..@.@...@.@@......@....@.@..@@....@@...@.@.....@@...@..@
........@.........@@.....@........@@.@.....@@.@@...@@.........@..@....@.......@.@.......@.@............@@........@.......@...@@@
..@@.@.@@.......@..@.@.@.......@....@.@@..@....@...@@@......@@@@.@.......@....@...@@@.@@.....@.@...@.@..@........@...@@@.....@..
.@.@......@@.@..@@..@...@.@@....@@.......@...@..@@..@...@..@@....@.@...........@...@.@@...@@.@@....@.@...@.....@.@.@.@...@@@.@..
.@.@@.@........@@@....@..@@@@.@@@...@...@@.@..@...@........@.............@...@@..@....@@.@...@@.@..@.@..@@.@.....@@.....@..@...@
.@.@@@..@@.......@.@.............@.@....@@.@....@....@..@@@@......@@..@.......@.........@@@.........@....@..@...@..........@.@..
.@.@@..@@@.@@@.@@.@........@@@@....@...@.@....@@@.@.@.@@.@@@..@.......@@.....@.@@.........@....@@......@......@...@.@@@..@....@.
...@.............@..@.@.@..@.@........@@.@....@@.......@..@...@....@.@.@.@..@..@...@..@@..@.@@@....@.@...@..@..@............@.@@
.@@@............@....@@.....@@.@.@.@........@.......@........@..@@..@..@..@..@@.@.@.@....@...@..@@@.@@.@...@..@.......@.@..@...@
..@..@@@.@@..@..@.@.......@.@@..@@...@....@...@..........@...@..@@..@.@@.....@.......@....@....@.....@.@..@@.......@@..@.....@..
.@@..@@.@@.......@@@...@.@@..........@.@...@@.......@@..@@@@.........@.........@@@........@.@...@..@.......@.@...@@...@........@
.@@@.....@@......@..........@........@.@..@.@.@............@....@..@@@....@@@@...@.@....@@..@.....@..@.@........@@.@@@....@.....
.@...@.@@..@...........@.@@..@@@...@@@....@.......@...@@...@........@....@....@...........@@@.@@..@..@@.......@........@.@@.....
.@....@@@@.@.......@.@.........@@.....@..@.@@....@......@@.........@..@@.@...@...@@..@...@.@........@.@.@..@......@@@........@..
@.......@@..@.@..@..@..@.@..@.......@.........@.....@....@..@@.@@@.....@.......@.@@..@....@..@.@...@.@...@.@.@.@..@.........@@@.
.@....@........@...@....@.....@.@...@...@.@..@....@......@...@.......@.....@@....@......@.@@....@.@.........@@@@@..@.@@.@.....@.
........@@....@...@@........@....@.@..@.@@.@@..@..@.........@...@...@@.@@...@@@...@.......@.@..@@@..@......@...@@.@.@...@..@@@.@
@@...@.@..@.@@.@.@.@..@.@@.....@@@.@.@@..@@.@...@..@..@...@..@......@.@@.......@@@@....@.@..@@@.@@@.........@..@.....@....@.....
....@.....@........@.@@@...@.....@..@.@.@@....@.......@....@..@@..@.@......@@...@..@....@.@@@.@@..@@@...@.@..@@..@@.......@.@.@@
.@...@@.......@...@..@..@..@@......@...@@.@..@.........@..@....@....@........@@.@..@.@.@.@@.@.............@..@........@.@.@@.@..
..@......@@@.@....@..@.@..@@..@............@..@.@..@.@.@..@@.@.@.@@.......@@.@...@@@......@...@...@.@@......@@.....@........@..@
..@@.@..@@..@@....@.@...........@..@.@.@.@@@..........@..@......@@@.@..@....@.........@@...@.......@....@...@...@..@@....@@@@@.@
....@@@..@..@.@@@..@..@.......@@.@.....@.....@....@.......@@@@.......@.@.@@@...@@.@.@.@@@......@...@..@.@..@@.....@@..@....@.@..
..@@.@....@..............@.......@.....@.........@@@........@..@.@.@...@..@@@..........@.....@...@.@.@.@....@.@..@@@..@..@@...@.
@......@.@.@.@@....@.@....@.@......@...@@....@.........@@..@.@.@...@.......@...@..@.@..@....@@@.@@@.@..........@@..@@@...@.@@...
.@..@..@....@.@@@..@...@@@...@....@@.@@@.@.......@@@...@....@...@.@...@@...@@.@.@@..@@..@@@.....@.@...@..@.@........@..@......@.
...@@@.@..@@@.........@.@.@.......@@.@.........@@..@.@.......@@...@@....@.......@@.@....@....@.@..@.@.@.@.@@..@...@.@...........
@@..@@......@.....@@...@...@..@.@..@@..@.........@..@@..@@.@@......@....@..@..@.@@..@.@.@@......@.@....@@.@@...@........@.@@@@..
.@........@...@@..@......@....@.@.@.......@...@.........@@....@.@@...@...@.@@@@.@@..@.@@.@.@...@@........@....@@@.@........@...@
........@....@@........@@....@@@.....@.@..@@....@.@.@.@@@.@...@....@...@.@..@.@.@..@.@@@.@...@...@...@.......@....@...@.@@@@.@.@
........@..@@....@....@.@...@.@@.@....@......@.......@@.......@@.@@.@...@..@........@....@@.@@..@.@@...@..@@..@@@....@..........
.@..@..@....@.@@@@@.@@@@..@.@@...@...@.@...@.@.@@@......@...@.@.@.....@@.@@..@..@..@@..@@...........@...@.....@@...@@...@....@@.
...@.@.....@@@..........@..........@...@@...@....@..@....@.....@@.@...@@..@...@....@@..@..@.@...@.@...@@...........@.....@.@...@
..@.....@@@....@..@@@.@........@@.......@@.@@@.@@.@.@.................@.@...@....@.@@......@..@........@...@.@.@@@....@@...@@..@
.@.......@@....@............@....@@@......@...@....@@.....@@@.@.....@..@@....@..@@.@.@..........@....@..@....@.@..@.........@@.@
...@@..@..@....@.@.@.@........@@.@......@....@.......@@..@@......@....@....@.@.@.@.@@@@...@..@@.....@@@.....@..@@.@..@@.@@@@@@..
@...........@.......@@..@@.@@@..@..@@.@@.@....@.@@.......@@@...@.@.@@.@..@@....@......@.@@.@@.....@@..@.......@@.....@...@@.....
.@.....@.@.@..@...@...@@@.@@.@..........@.@.@.@....@@@...@.@@@..@...@@..@@..@@@......@.@.@@...@.@...@..@..@@....................
..@.@@.@.@.@@@..@.....@.@@@@.....@.@@@@..@@.@.@..@.@@.@..@.@...@.@..@@...@........@...@@@..@@.....@.....@@...@@@.....@@...@...@@
.......@.@...@@@..@....@..@.@.@@@@.@@.@......@@........@@......@..@@.............@...@@@.@.......@.@.@...@.@@..@.@@............@
....@.@@@@........@.@....@@...@....@........@.@....@..@..@....@.@.........@..@.@@....@@@..@....................@@.@..@..@@@...@.
@...@@...@...@.....@.@.@.@.@..@....@@@..@..@@.@...@@.........@...@...@...@@@@.@....@........@...@@..@.@..@.@...@.........@@....@
.....@.@..@@...@.@.@@.@@..@@.@.@@@........@@.......@...@.@....@@............@....@.@...@...@@...........@....@...@.........@.@@@
@.@...@..@@..@@..@...@@.@...@.......@.@@..@...........@.......@...@@@@.@..@@....@.......@@@...@@...@@.@..........@........@.@.@.
..@..@@.@...@.@@@.@......@..........@..@.@@...@..@.@......@@.@.@.....@.....@..@@@@@@..........@......@....@.@.@.............@.@.
@..@.@..@@.......@.@.@@.@@........@.@..........@@.....@.@.......@@..@.....@......@.......@.....@.@@..@@.@........@.@@....@..@..@
@.......@......@@.@@....@.....@..@.@.......@..@..........@......@..@.@...@@.@.@..@.@.@@...@.@...@....@..@@@.......@.@...@.@@..@.
@.....@@@....@.@@...@.@.........@@@@@....@...@..@.@.....@@.@..@.....@@.@.......@@.......@@...@...@.....@.@..@..@@.@@.@@....@....
..@.@..........@...@.....@....@.........@@.@.............@@@..@@@@...@..@@@...@..@..@@.@@.@@.@@@.....@.@......@@@.@@.@@.@@..@.@@
@.@.@..@......@@@..@.@@@@.@.@..........@@....@..@........@...@@...........@.@.....@....@@@.@.@..@@.....@.....@@@@..@..@....@..@@
@@.....@...@.@....@@@.@@@.....@@@........@@@@@......@.@....@@.@.@.@@@@....@.@...@.@..@..@...@.@..@.@@....@....@....@.....@@@...@
.@.@......@.....@.@@..@.....@@....@..@...@...@@......@.@..........@@.@........@@@.@.@.@...@@...........@@....@@..........@....@.
@......@..@.@.@................@.@..........@@......@..@.....@..@.@...........@@@.@..@..@.@@....@......@@@@.@.@@@.@..@.@....@...
...@@@.@@.....@..@.@.............@...@.@...@@@@@@@@...@@.@..@..@@@..@@.@....@.@..............@....@.....@.@@.@.@@.@..@..@@@.@...
@@..@..@...@...@.@...@...@...@...@@..@.@......@@@.@@...@....@.....@@.@@...@..@.@.....@..@...@.......@@.....@......@..........@..
.@...@@...........@.@..@@@....@@.@...@@@..@....@........@..@...@...@@.....@@@.....@@.@@..@@........@@.@...@...@@..............@.
..@@@.@.@.@@@..@.......@..@.......@.@..@@.@.....@..@..@@..@@.@@@.......@..........@@..@..@@.@....@.@.@@@@.............@@....@@@.
...@@.@@..@.@........@...........@...@@@.@.....@@..@...@@.......@.@.......@.....@..@......@...@.....@..@@@..@.........@....@..@.
.@...@......@.@.@........@@.@...@..@....@....@.@.@@.@.....@....@.@..@@@.....@..@....@.......@.....@@.@@..@............@@@@......
.@.@......@.@..@@......@..@@.@@@.....@@.@...@@..@@..@...@....@@@.@@.....@..........@......@..........@...@..........@@@.@...@.@.
.@@.........@...@....@.@@.@..@@@@..@.@@.@@..@........@@@@.@.@.@.@...@.@@.@.........@.@@...@@@...........@@.@@.......@@..@@..@...
....@@.@@@@.@@....@.@@.@..@@.@.@......@@.@.@@..@@@@@....@......@.....@..@@..............@...@..@..@@...@@...@@.@.@@...@...@@....
@...@.@....@@...@........@@....@.....@...@....@........@....@@.@@.@@...............@.@.@..@@...@...@@..@.......@@...........@...
...@@.@@@..@.@..@.@.@.@@.@@....@..@@@....@@@...@@.@.@..@..@..@@@@..@........@@@@.@...@...@@.@.....@........@...@...@@.@@@..@.@@@
.....@.@@@@@..@@@.@.......@...@@.@..@@@.....@...........@..@..@.....@@@.....@......@..@.@....@@..@.@....@@..@......@...@@@.@@@@.
...@...........@.@...@.@....@...@..@.............@...@..@.@@...@@............@@..@.@@..@@.@.......@.@..@...@..........@.@..@@...
.@@@@......@.....@...@..@@.@@....@.....@.@.....@.@.@.@@...@.@..@....@.@..@...@......@..@...@...........@..@..@@....@@@...@.@..@.
.....@.....@.........@...@....@...@......@@.......@.....@..@..@..@.......@.....@......@..................@.@.....@.....@......@.
......@@@@@@@@..@....@@....@@@...@......@@@.....@.@.@...@......@...@@@.@@@..@..@@..@...@@@..@.@.@.@...@@....@@..@@.@.....@@@..@.
@.@..@@.@..@.........@..........@....@..@@@.....@@...@..@@.....@@.@.....@......@......@.......@@..@..@.@@...@..@....@...@.@.....
....@.@@........@..@..@@@...@.@@..@..@......@@..@@...@...@.@...@...........@.@.@..........@.........@...@@.....@@.@..@@....@..@.
@....@.@@.....@....@....@.......@..@...@@...@.@.......@.@@.....@@....@.@...@@.....@..@..@..@.....@@.@@......@..@.@.......@......
...@@@.@.....@.@....@.@.@@.@.....@@.@.@.@..@@.@@@..@.@.@@...@..@@.@@@..@@..@.......@.@.@@@.@@.@................@....@..@@@....@.
@.@.....@...@@.@..@..@...@@@..@..@@.@.@.......@@....@@......@@.@.@@.@....@.@.....@@.@@.....@....@@@.......@@..@.@.......@.@....@
......@@.@..@........@.@...@@.......@@.@............@@@...........@..@....@...@@..@..@@.....@@@..@@..@...@...@.@....@...@......@
.@.@@..@.....@.@....@..@@@@..@@@....@.@@@.@.@.......@....@.@.@@@@.......@.....@...@@.@@....@..@@.........@.......@..............
............@.@@...@...@.@.@@@.@.@.@........@@..@.@...@..@...@@........@..@....@..@..@@....@@..@...@...@...@....@..@@....@...@..
......@.....@........@...@@..........@.@...@.@..@.@....@.@.....@..@....@.........@.........@..@@........@....@.@..@..@.@..@.....
@...@@..@......@.....@..@..........@...@@@@....@..@@.@......@.......@....@....@......@@.............@..@@...@......@..@..@.@@@@@
@.@@@@..@@.@@...@.@.@.@......@..@....@....@......@..@...@@.@.....@...@@..@@@..@@.@...@@..@.@...@@..@.@@.@....@.......@@.........
@.......@............@@@..@.@................@...@@......@@......@.....@.........@.......@.@..@...@....@...@@@...........@@@..@@
.@....@....@..@.@@@.@..@.......@...@.........@.....@.@.@..@@...@@.@.@.@...@.......@....@..@...@.@..@@@..@...@..............@.@@.
@...@...@@........@...@...@.....@@............@......@....@@@.....@..@.....@..@@@...@...@.@@......@..@.@..@..@..@@.@............
......@....@@.@............@....@...@@....@@........@..@@@..@..@....@...@.........@.@..@........@....@.@.@......@@.@...@..@@@.@.
@...@.@@..@.....@@@.@....@.....@...@..@@..@...@..@.......@@...@.@.@............@...@......@@..........@@@@......@..@......@@..@.
....@@@.......@@..........@..@@..@..@@@@@@.......@@@.....@@@@..@@..@..........@@.@@..@..@...@...........@....@......@.@.....@..@
......@@@@.............@.......@..@....@@..@..........@.@@...@.......@..@@.....@.@.@@@...............@..@....@.......@.@.@@@....
..@@...@.@@.......@...@@.....@..@......@....@...@.@@@@@@@..@@@@.@...@@@....@.@@@.@..@....@..@.@.@@...@..@@@...@@.......@@@.@@@.@
...@.........@@..@@..........@@.@@....@....@..@....@.....@.@.............@...@.@.......@..@.@@...@.@..@@.@.@@..@...@.@...@......
....@....@........@...@.....@@@..@....@..........@@@....@..@.@.....@.@.@.@......@..@.....@@.......@....@..........@.....@......@
@...@......@@.@....@.@.@....@.....@@@..@@@..........@.@..@......@@@....@..@@......@@...@..@.@..@@.@...@.....@.@@@.@....@.@@...@@
@@..@@.@..@@....@...@@@.......@..@.@.@.............@@......@.....@...@......@................@.........@..@@...@....@......@@..@
@.@........@@....@.........@@@@.@..@@@......@@.@@.....@.......@...@@@..@...@@.@..@...@@@....@..@@@..........@..@...@.@..@.@..@.@
.@..@....@.@..@.......@.@@@@...@...@...@......@.@...@.@@....@....@.@......@@.@.@...........@@@..@...@.@...@........@.@.@.@@.....
.@@@@@.@........@@@....@...@.....@...@.@...@..@@..@...@...@.@@@.@..@.....@....@...@.@...@......@....@.......@@@@..@.@....@.....@
..@..@..@..........@....@....@@@......@@@.@..@@@..@@..@.......@....@.@...@.@...@..@.@@...@..@.....@..@.................@..@.@...
@..@.@..@.@..@@.@..@@...@...@......@@.@.@@..@.@@....@..@..@@@..@...@@.@.@......@@@..@.@@..@@@@.......@@.@..@............@....@.@
.....@@...@.....@....@.@..........@..@@@@..........@.@...@.@..@@@@.@................@....@.@.....@.....@...@.@@...@...@..@@.@...
.@.@.......@@.....@@..@....@@..@.......@...@@..@......@.@.......@.@..@...@...@...@...@....@.@..@.....@.@@@.........@@.@@..@..@.@
@...@.@..@....@@.@@@.@......@@.@...........@.@........@.@..@@.@@@.........@@@@.@.@......@....@.@.@@..@....@...@..@.@..@..@@@....
@..@@.@...@..........@....@....................@@.@@..@@@.........@.....@.@.@.@.@......@...@..@.....@....@.@......@...@..@.@.@..
.@.....@.....@......@@@@.@@.....@@...@....@.@@@.....@.@@.@....@.........@..@..@...@..@@..@.@...@....@...........@.@@@...@...@@..
@.@.@..@@......@@.@...@@..@.@...@.......@@@.........@.@.@...@.@.......@.@.....@.@......@@.@.@.@.@.@@..@.@.@@....@..@@......@....
@.@..@@@@@...@@.@..@@....@.........@......@@..@.....@......@..@...@..@...@.@@......@.@@.@@..@@....@@..@@@.@@..@@@....@@...@@@@@.
..@......@@@..@.@@..@..@....@...@@..@@..@@@.@@..@@......@.@@.......@.@..@@...@.@....@@......@..@.@...@.@@@@.........@....@.@@.@@
.@.....@@.@...........@.@...@@@@...................@...@.@@..@@.....@.@@@@@@.@@....@@....@@..@......@...........@.@...@.....@..@
@@...@@.@......@@.@...@@.@@@...@..........@...........@.@..@.@@@....@.@..@.@.@......@.....@.@.......@@......@.@.......@.@....@@.
@..........@@.............@.....@@..@..@@....@@.......@....@.@@@...@.....@@@..@.........@.....@@@.@@.@..@@....@...........@.@...
....@.........@........@@......@...@@@.@.@.......@@@@@@....@..@..@..@....@..@@@........@...@.@.@.@@.@.......@...@..@@.......@...
@.@.....@..@@@..@..@.@@@.@......@...@@.@@..........@..........@....@...@.@......@.....@...........@.@@....@@...@...@@.......@@..
...@.......@@...@@.@.....@.@.@.@.....@..@...@...@.@@@.@.@@...@.@@...@.@.............@@.@.@.@.@...........@..@.@......@.@...@...@
.@@.@..@.....@.......@..@@..@..@.@...@.@...@..@........@.....@.@..@@@@.....@.@@..@..@...@@...@@@.@......@......@@...@.@..@.@....
.....@...@.......@....@@@.@.@@.@....@.@.@..@....@........@.......@@....@.@....@@..@...@..@....@@...@.....@.@@@@..@..@.@.@...@@@@
@..@.@..@....@..@.@.@..@@@.@....@@.....@.@..@@...........@.@..@..@.......@...@@...@......@..@...@..@..........@...@@.......@@.@.
...@....@@..@@..@.....@.@@....@@.....@...@@@@.@...@..@....@...@..@......@..@.....@.....@.....@........@..@@..@.......@.@.@@@..@@
............@@...@@@.@......@@@.......@..@@@..@.@..@...@.....@..@..@.@.....@@....@...@@.......@@..@........@..@.@...@.@.@@@..@..
..@..@.@@...@.@.@@.@.@.@.@.............@.@......@.@..@@.@@.@......@@..@@..@.@..@.......@.........@@.@.@.........@@........@@..@.
.........@@..........@.@@.....@@.....@.@..@..@@@@.@@...@..@.......@....@.@........@..@@..@.....@....@@.....@..@.@...@...@.@.....
@@.@@...........@.....@.....@..........@@@@.......@...@...@.@@@@@.@@...@@..@.@@..@..@@.@.....@......@..@@@...@@.@...@....@.@.@..
...@..@.....@.@@@@@...@...@......@...@@.@....@@....@...@.@.@....@....@..@@@.@@..@...@....@@@...@@......@@.@@@@.@.......@..@..@.@
@..@@...@.@..@.@@.@..@...@@@.@@.@..@.@...@@@...@@@....@.....@......@......@@............@@..@.............@..@.@.@.@@.@.@..@....
