type heuristic
height 100
width 100
unnecessary line of text
...............@............................@.@........@.@...@......@.@....................@........
@......@.@..........@.....@.@...........................@.........@..................@@.@...........
.............@.......@...@@....@.@..@.....@.....................@....................@..............
.....@............@.........@....@........@........@..@.........@..@......@.........................
@.........@......@...@..@.@.......@..@.@.@..............@..@.@....@..@.......@......@...@.........@.
......@..@...@....@..............@..@.@.....@.............@@.........................@....@.........
...........................@........@.........@.....@....@....@.@@@@......@...@...@.................
...........@@..@...@.......@..........@...............@..........@............................@.....
.@.@.....................................@..........................@@...........@..................
...@.....................................@....................@......@.............@...@............
@.....@...@...@....@..@...........@.@.@....@........@.....@.....@.............@@..............@.....
..............................@..@......@..................@...@........@...........................
.................@..@.............@...@............@...............@..@............@@...............
...@............@.......@........@....@.@.......@.................@....@........@..@...............@
.@@..@.....@@.......................@.............................@.......@...........@.............
.........................................@..@.......@.......@..@@...........................@.......
..........................@.....@....@..@..............@...............@...........................@
.......@.....@.....@..........@.....................@...@..@.........@.....@................@.@.....
.@...@........@.@.....................@.@......@.........@..........@........@@....@............@...
........................@..................@....@..@...............@................................
...@.......@....@....................................@@..@@.........@..............@..............@.
......@.......@.....@@..@..@.@@.......@............@..........@.@..@............@...@.@.@.@.........
.....@.......@.@...................@...........................@...................@........@....@..
...............................@.........@.....@.......@.........@............@..@..........@.......
.....@....@....................@....@...@.............@@....@....................@........@.........
....@....@..@...........@.@...............@.......@@@.....@.@............@.....@...@...@............
............@....@..........@........................@..........@.......@.......................@...
..........@......@.......@...@@..@...@.......@......@.......................@@..........@...........
............................@.......@..............@......@.....@..@...........@.........@.....@....
@..........................@@.@.............@........@............................@........@....@...
.@.....................@...................................@....................................@...
......@...@.@.............................@..@@...@..............@...............@...@............@.
................................@..................@.@......@...........@.@.........................
.......@..@.@.@.........@..@...........@............@.....@@@.@@....@..@..........@.........@@......
........@.........@.......@..@..............@........@....@.@.@.............@.@.............@.......
...........@...@.@...@...@.........................@.@.....................@.@............@.......@.
....@.@............@..................@...........@..@@........@.@........................@..@@.....
.............@..............@@....@.....@@....@............@...@..@..........@.@..@........@........
.@...@....@....@.@.......@.........@...........@....@@.@.........@.........................@.@@.....
......@............@..............................@..........................@....@.@...............
.................@........................@.@.........................@.............@....@..........
......@.@@......@............@.@..@......@..................@.....@@................................
....@@....@............@..................@..................................@......@....@..@.......
................................@.........@........@.........@..................@...........@.......
....................@..............@.......@.....................@......@......@................@...
..............................@..........@.......@.@....@.@.@...@.@...@..........@@.....@..@.@......
........@.............@..@.............................................@................@......@....
@.....@...............@.............@...@......@@..........@........................................
......@..@.@.........@...@..........@.......................@............@..........@..@..@@........
.............@...............@@@..........@@.............@..@........................@..@...@.......
...@...........@@.................@......@.......@.....................@@................@.@........
....@.........@................@......@...........@........@.....@@....@..@.@.......................
...@@...............@..@..@....................@@....@.................@.......@......@...@.@.......
.....@............@......@..........................@.........@............@.....@@.....@..........@
.............@.....@.........@.@.........@....@.....@......@................@....................@@.
.................@@..@......@.@........................................@....................@.......
.................@.@......@..................@....@..................@................@...@@........
...@.........@.@......@.................@..............@.....................@...@...............@..
.......................@..@..................@...@.......@......@.@.....@...............@......@.@..
@..@..@..............................@...................................................@...@..@@..
........@...@..@..........@..................@......@@..@..@..@..................@..@...............
......................@...@.................@..@.......................@.........................@..
.............@.............@........@..@......@...@@............@...@..............................@
..@@..............@.....@.......@.....@........@.....@......@@...@.............@..@......@..........
......@@............@....@@....@......@..@....@....@....@................@.......@...@..............
....@.......@................@....@........@.@....@........@....@@.....@......@..@..................
..........@...@.......@...........@........@@.........@....................@.......@........@...@@@.
@...@..............@.................@..................@.........@.@........@........@.@...........
..@......................@........@....@......................@...@.@...@....@.......@....@....@....
....@.....................@............@..@..................@......@...............................
....@.......@...................@......@.....@..........@..@.........@....@..@.@.......@@..@@..@....
...............@@...@.........@..............@.........@...........@..................@...@......@..
..........@....@....@...................@........@......@.@..........@........@@.........@.@........
@..............@...........................................................@.....@...............@@.
.................................@...@...................................@..........................
.................@@@...............................@..@@.......@..................................@.
..........@..@.@@.@......@........@...........@......@.@........................@@....@.............
.......@....@@@.......................................@...............@...............@.............
@.........................@.....@....@........................................@.....................
.............@..........@..........@....@.....................@...@................................@
..............@........................@.......@....@........@.....................@........@....@..
.....................@...@.@..@.................@...@...@...............@...................@.......
...@..@.............@...@...............@.........@...........@.........................@@..........
@........@.........@...@......................@.@..@.......................@........................
......@.....@........@.........@....@..@..............@.........@....@....@...@.....................
..............@...@....................@@..............................................@..@.......@@
.@......@....@..........@....@..................@.......@..........................@...@@..........@
..@............@........@................@..............@..........@..............................@.
...@.@................@@............@.........@...............................@...@.....@..@...@.@..
@@........@..@....@...@..@...............@............................@..@....@...@..............@@.
..@...................@..........@.............@.........................................@.......@..
.@........@....@.......@......@.......@.@..........@.@.......................@........@.....@.......
...@..............@....@..........@........@.........@.......@.......@........@.....................
@.......................@.............@.@..@......@...............@............@........@@..........
......@...@...................................@.......@...@..@............@.@....................@..
.........@@..@......@.............@@....@.@@..@..@..........@.@..@.....@..@.......@......@.@.....@@.
.....................@.........@..@@......@.........@.........................@........@@...@....@..
.@..........@...................@..@@........................@...@..................@@..............
............@....................@.........@........@...........@............@..........@...........
...................@........@..............@@....@............................@.....................
